#############################################################
#                             #                             #
#                             #                             #
#                             #                             #
#                             #                             #
#                             #                             #
#                             #                             #
#                             #                             #
#                             #                             #
#                             #                             #
#                             #                             #
#                             #                             #
#                             #################   ###########
#                             #                             #
#                             #                             #
#                             #                             #
#                             #                             #
#                                                           #
#                                                           #
#                             #                             #
#                             #                             #
#                             #                             #
#                             #                             #
#                             #                             #
################    #################################    ####
#                                                           #
#                                                           # 
#                             #                             #
#                             #                             #
#                             #                             #
#                             #                             #
#                             #                             #
#                             #                             #
#############################################################
